,true_EC_number,predicted_EC_number,confidence_score,model_num
0,1.1.3.8,1.1.3.8,0.9999055770813693,1
1,1.14.11.36,1.14.11.36,0.9999999912372814,1
2,1.1.3.42,1.1.3.42,0.9999999845593238,1
3,1.14.11.6,1.14.11.6,0.9999996998989527,1
4,1.11.1.16,1.11.1.2,0.6997305936126361,1
5,1.13.11.88,1.13.11.88,0.999999595416842,1
6,1.1.99.1,1.1.99.1,0.9999999999765095,1
7,1.1.3.45,1.3.3.14,0.9999990993075201,3
8,1.14.11.45,1.14.11.45,0.9978224952984954,1
9,1.13.11.8,1.13.11.8,0.999999999925258,1
10,1.1.99.12,1.1.99.12,0.5178514273727192,1
11,1.13.11.9,1.16.3.1,0.2847515353500077,3
12,1.14.11.8,1.14.11.8,0.9999999999670308,1
13,1.1.2.5,1.1.2.5,0.9999996703357478,1
14,1.13.11.58,1.13.11.12,0.5071149107248472,1
15,1.1.98.5,1.1.98.5,0.9999990401839215,1
16,1.1.99.14,1.1.99.14,0.999993644252428,1
17,1.1.3.39,1.1.3.39,0.9999999999753513,1
18,1.13.11.74,1.16.3.1,0.9995180690124661,3
19,1.1.3.37,1.1.3.37,0.9999999993661959,1
20,1.13.11.15,1.13.11.15,0.9999951632938617,1
21,1.1.99.27,1.1.99.27,0.9999997498858548,1
22,1.13.11.45,1.13.11.45,0.8602659788348953,1
23,1.12.98.3,1.12.98.3,0.999999708925827,1
24,1.13.12.17,1.14.13.25,0.4942361667188585,2
25,1.1.2.9,1.1.2.9,0.9999999990717043,1
26,1.14.11.61,1.14.11.61,0.999999938976922,1
27,1.11.1.11,1.11.1.11,0.9999323397109637,1
28,1.13.11.26,1.13.11.26,0.9999983710602913,1
29,1.14.11.72,1.14.11.72,0.9999999999996803,1
30,1.1.99.32,1.1.99.32,0.9999989775600153,1
31,1.14.11.20,1.14.11.20,0.9999999917745299,1
32,1.10.3.16,1.10.3.16,0.999999993782005,1
33,1.1.99.9,1.1.99.9,0.9998798704520787,1
34,1.14.11.61,2.8.3.17,0.9999996527046057,10
35,1.14.11.64,1.14.11.64,0.9999999245203626,1
36,1.14.11.1,1.14.11.1,0.9999999985464072,1
37,1.1.3.42,1.1.3.42,0.9999990850333298,1
38,1.13.11.58,1.13.11.58,0.9999513785122223,1
39,1.1.99.12,1.1.99.12,0.9998606928321788,1
40,1.13.12.24,1.13.12.24,0.9999994003793397,1
41,1.13.11.31,1.13.11.31,0.5837708860468813,1
42,1.14.11.60,1.14.11.60,0.9999999984484234,1
43,1.13.11.78,1.4.3.19,0.8649364518233413,4
44,1.12.5.1,1.12.5.1,0.9999997950746181,1
45,1.13.11.45,1.13.11.45,0.9982962517529632,1
46,1.13.12.16,1.13.12.16,0.9999999212207729,1
47,1.13.11.6,1.13.11.6,0.9999974846165197,1
48,1.1.9.1,1.1.2.8,0.685160435618971,1
49,1.1.99.20,1.1.99.20,0.9955971679118123,1
50,1.14.11.47,1.14.11.47,0.999995440786021,1
51,1.10.2.1,1.10.2.1,0.9999999933833692,1
52,1.11.2.1,1.11.2.1,0.9989386021164303,1
53,1.13.11.18,1.13.11.18,0.9999999999064428,1
54,1.1.3.23,1.1.3.23,0.999999999329745,1
55,1.1.99.18,1.1.99.18,0.9999997087146892,1
56,1.1.99.29,1.1.99.29,0.9871258771142971,1
57,1.13.12.4,1.13.12.4,0.9995708063874136,1
58,1.13.12.24,1.13.12.24,0.9999995745331612,1
59,1.14.11.57,1.14.11.57,0.9986064709121841,1
60,1.10.3.4,1.10.3.4,0.7791491319455642,1
61,1.14.11.75,1.14.11.75,0.9999999999403641,1
62,1.13.11.76,1.17.9.1,0.8358428567042263,3
63,1.11.1.1,1.11.1.2,0.5930806192844252,1
64,1.11.1.24,1.11.1.24,0.9999992266502252,1
65,1.1.9.1,1.1.9.1,0.9124768651774726,1
66,1.1.99.1,1.1.99.1,0.9999999988235118,1
67,1.1.5.9,1.1.5.9,0.999996995812485,1
68,1.1.3.41,1.1.3.41,0.9999991759613265,1
69,1.14.11.21,1.14.11.21,0.999999998127997,1
70,1.14.11.2,1.14.11.2,0.9999998377149087,1
71,1.13.11.46,1.13.11.46,0.9999999609433993,1
72,1.13.11.18,1.13.11.18,0.9999999997088054,1
73,1.11.1.17,1.11.1.17,0.9999999983084535,1
74,1.14.11.9,1.14.20.6,0.9902708851153732,3
75,1.1.99.21,1.1.99.21,0.9998842898500261,1
76,1.11.1.13,1.11.1.13,0.9993591286014778,1
77,1.13.12.24,1.13.12.24,0.9999997437406671,1
78,1.14.11.35,1.14.11.35,0.9999999998649685,1
79,1.12.7.2,1.12.2.1,0.6953770301351422,1
80,1.1.5.3,1.1.5.3,0.9999999928132794,1
81,1.1.99.42,1.1.1.107,0.9744859110343916,0
82,1.13.11.78,1.4.3.19,0.703882557067687,4
83,1.1.3.50,1.1.3.50,0.9999999742359978,1
84,1.13.11.5,1.13.11.5,0.9622088269330552,1
85,1.10.3.9,1.10.3.9,0.9999999839698576,1
86,1.11.1.17,1.11.1.17,0.9999999999952536,1
87,1.1.3.46,1.1.3.46,0.9999915593642854,1
88,1.1.5.13,1.1.5.13,0.9999908204166746,1
89,1.10.5.1,1.10.5.1,0.9999997426990899,1
90,1.13.11.74,1.16.3.1,0.999595565981131,3
91,1.14.11.81,1.14.20.13,0.7209784844366286,3
92,1.10.3.5,1.10.3.5,0.9986466695625368,1
93,1.11.2.2,1.11.2.2,0.9998811879516594,1
94,1.13.11.60,5.4.4.6,0.9975374844081282,15
95,1.13.11.47,1.13.11.47,0.9998320043858242,1
96,1.13.12.1,1.13.12.1,0.9999998752644934,1
97,1.1.99.38,1.1.99.38,0.999998475457016,1
98,1.14.11.6,1.14.11.6,0.9999999999306226,1
99,1.14.11.57,1.14.11.56,0.978627069879599,1
100,1.10.5.1,1.10.5.1,0.9999978663014834,1
101,1.14.11.40,1.14.11.40,0.9999999486886622,1
102,1.14.11.11,1.14.20.13,0.9999999993626076,3
103,1.14.11.66,1.14.11.66,0.99999999325766,1
104,1.1.3.5,1.1.3.5,0.9291243002476752,1
105,1.13.11.50,1.13.11.50,0.9999998992235584,1
106,1.10.5.1,1.10.5.1,0.9999951487600149,1
107,1.13.11.11,1.13.11.11,0.999999996111768,1
108,1.13.11.43,1.13.11.43,0.9999999961834547,1
109,1.13.12.7,1.13.12.7,0.9999739434379243,1
110,1.14.11.75,1.14.11.75,0.9999999992499014,1
111,1.1.3.7,1.1.3.7,0.997276570798949,1
112,1.1.3.27,1.1.3.27,0.9999999999998508,1
113,1.13.12.1,1.13.12.1,0.9999562361256092,1
114,1.1.3.45,1.3.3.14,0.9999832515058422,3
115,1.1.5.14,1.1.5.14,0.9999995681472535,1
116,1.1.2.5,1.1.2.5,0.9999996923658909,1
117,1.11.1.14,1.11.1.14,0.9546116717248291,1
118,1.13.11.52,1.13.11.52,0.999999990883687,1
119,1.13.11.78,1.13.11.78,0.9999999999994031,1
120,1.1.3.23,1.1.3.23,0.9999999998129496,1
121,1.14.11.73,1.14.11.73,0.9999999870696429,1
122,1.13.11.19,1.13.11.19,0.9999026769842897,1
123,1.14.11.82,1.14.11.82,0.9999999952973937,1
124,1.10.3.1,1.10.3.1,0.9999983509393172,1
125,1.13.12.24,1.13.12.24,0.9999999718073345,1
126,1.1.3.39,1.1.3.39,0.9999999998194156,1
127,1.14.11.47,3.4.23.52,0.8662886388349428,12
128,1.13.11.75,1.13.11.75,0.9999067779715836,1
129,1.10.3.11,1.10.3.11,0.9999999589853781,1
130,1.13.12.15,1.13.12.15,0.9999991691756277,1
131,1.13.11.35,1.16.3.1,0.8709758092990265,3
132,1.1.2.5,1.1.2.5,0.9999999855575866,1
133,1.12.1.3,1.12.1.3,0.7732590962957825,1
134,1.1.3.45,1.1.3.45,0.9999999888206333,1
135,1.14.11.8,1.14.11.8,0.9999999693856272,1
136,1.13.11.91,1.13.11.91,0.9999934290688254,1
137,1.14.11.41,1.14.11.41,0.999999999968253,1
138,1.11.1.24,1.11.1.28,0.9928835704109059,1
139,1.1.99.29,1.1.99.29,0.9992743642007642,1
140,1.1.99.1,1.1.99.1,0.9999999999837641,1
141,1.14.11.35,1.14.11.35,0.9999999999896758,1
142,1.12.1.2,1.12.1.2,0.9417424305238267,1
143,1.11.2.3,1.11.2.3,0.9999999999068123,1
144,1.12.98.3,1.12.98.3,0.9999998530585367,1
145,1.13.11.3,1.13.11.36,0.5083072865022353,1
146,1.13.11.87,1.13.11.87,0.5586242543391869,1
147,1.1.98.4,1.1.98.4,0.9999988399167862,1
148,1.13.11.81,1.13.11.81,0.9999999995148272,1
149,1.14.11.65,1.14.11.65,0.9999999999987779,1
150,1.13.11.41,1.13.11.41,0.9999999996700524,1
151,1.1.3.44,1.1.3.44,0.9999999998628795,1
152,1.13.11.80,1.13.11.80,0.9999882905538116,1
153,1.13.11.45,1.13.11.45,0.7301199417849896,1
154,1.1.99.9,1.1.99.9,0.9999969448507344,1
155,1.13.11.83,1.13.11.83,0.999999999077609,1
156,1.12.98.1,1.12.98.1,0.961614636652918,1
157,1.14.11.16,1.14.11.16,0.9999999963830746,1
158,1.1.3.13,1.1.3.13,0.9982988667526561,1
159,1.1.3.45,1.1.3.45,0.999999697247144,1
160,1.14.11.47,3.4.22.46,0.29445870839037064,12
161,1.1.99.36,1.1.99.36,0.9999999990012682,1
162,1.13.11.74,1.13.11.74,0.9999999934660622,1
163,1.14.11.67,1.14.11.67,0.999999999502748,1
164,1.14.11.1,1.14.11.1,0.999999999175337,1
165,1.13.11.41,1.13.11.41,0.999999999641247,1
166,1.1.3.2,1.1.3.2,0.992621776826675,1
167,1.14.11.46,1.14.11.46,0.999999999999865,1
168,1.14.11.76,1.14.11.76,0.9999999998552624,1
169,1.1.3.7,1.1.3.13,0.6186342987078717,1
170,1.13.11.40,1.13.11.40,0.9999895629115728,1
171,1.10.2.2,1.10.2.2,0.9999999981302565,1
172,1.13.11.22,1.13.11.22,0.9999999353607535,1
173,1.1.3.16,1.1.3.16,0.9999997881006533,1
174,1.10.3.3,1.10.3.3,0.9973247903179746,1
175,1.14.11.60,1.14.11.60,0.9999999904398251,1
176,1.11.1.6,1.14.13.106,0.8704216595599655,2
177,1.1.5.7,1.1.5.7,0.9999999976820391,1
178,1.13.11.36,1.14.20.4,0.7816787451136049,3
179,1.1.3.4,1.1.3.4,0.8839874386622104,1
180,1.13.12.8,1.13.12.8,0.9999995095545978,1
181,1.13.11.75,1.13.11.75,0.9999998903510974,1
182,1.13.11.18,1.13.11.18,0.9999999993794333,1
183,1.13.12.13,1.13.12.24,0.999988979746782,1
184,1.13.11.76,1.16.3.1,0.40272337833746996,3
185,1.13.12.2,1.13.12.2,0.9999999999703917,1
186,1.13.11.36,1.14.12.7,0.595807420454883,2
187,1.1.99.1,1.1.99.1,0.9999999996813926,1
188,1.13.11.5,1.13.11.5,0.9954898728242206,1
189,1.11.1.2,1.11.1.2,0.9999462067701128,1
190,1.1.5.9,1.1.5.9,0.5861299476601283,1
191,1.13.11.86,1.13.11.86,0.9999999999656097,1
192,1.14.11.21,1.14.11.21,0.9999999997572573,1
193,1.1.98.4,1.1.98.4,0.9999999973140703,1
194,1.1.5.11,1.1.5.11,0.9999966351862584,1
195,1.13.11.61,1.13.11.62,0.6566431818447914,1
196,1.13.11.24,1.13.11.24,0.999999999981938,1
197,1.14.11.6,1.14.11.6,0.9999999999274891,1
198,1.13.11.27,1.13.11.27,0.9999998839395371,1
199,1.13.11.68,1.13.11.68,0.48709142752225226,1
